       NO ./path_to_the_north_texture
            SO./path_to_the_south_texture
WE ./path_to_the_west_texture
       NO ./path_to_the_north_texture
EA ./path_to_the_east_texture

F220,100,0
C225,30,0
1111111111111101111111111vvvvvvvv
1000000000110000000000001vvvvvvvv
1011000001110000000000001vvvvvvvv
1001000000000000000000001vvvvvvvv
111111111011000001110000000000001
100000000011000001110111111111111
11110111111111011100000010001vvvv
11110111111111011101010010001vvvv
11000000110101011100000010001vvvv
10000000000000001100000010001vvvv
10000000000000001101010010001vvvv
11000001110101011111011110Dx111vv
11110111 1110101 101111010001vvvv
11111111 1111111 111111111111vvvv