C 238, 221, 187
	F 60, 48, 36

          SO textures/wall2.xpm
		NO textures/wall2.xpm
	WE textures/wall5.xpm
EA textures/wall4.xpm
	DO textures/door2.xpm
      1111111111111111111111111
      1000000000110000000000001
      1011000001110000000000001
      1000000000000000000000011
1111111110110000011100000111111
1000000000101000001110111111111111
1111011000001111011100000010001
11000000000000000010100100011111
1100000000E000000000100011111
11000000000000011000000100011111
1101010100000110101001000111111
1100000000010101111101111000111
1100111111101010111110111100111
11111111 1111111 111111111111
11111111 1111111 111111111111
