F 
C 225,30,0

          SO textures/wall2.xpm
		NO textures/wall2.xpm
	WE textures/wall5.xpm
EA textures/wall4.xpm
	DO textures/door2.xpm
1111
10N1
1111