C 170, 137, 113
F 60, 48, 36
SO textures/wall2.xpm
NO textures/wall1.xpm
WE textures/wall4.xpm
EA textures/wall5.xpm
DO textures/door2.xpm

1111111111111111111111111
1000000000110000000000001
1011000001110000000000001
1001000000000000000000001
1111111110110000011100000111111
100000000011000001110111111111111
1111D11000001111011100000010001
11000000000000000010100100011111
1100E000000000000000100011111
11000000000000011000000100011111
1101D10000000110101001000111111
1100000000010101111101111000111
1100111011101010111110111100111
11110111 1110101 101111010001
11111111 1111111 111111111111

