C 226,30,0
F 220,100,0
SO textures/p1.xpm
NO textures/p2.xpm
WE textures/p3.xpm
EA textures/p4.xpm

11111
10D01
11N11
10101
11111
