C 200, 175, 130
F 60, 48, 36
SO textures/wall2.xpm
NO textures/wall1.xpm
WE textures/wall4.xpm
EA textures/wall3.xpm
1111111111111111111111111
1000000000110000000000001
1011000001110000000000001
1001000000000000000000001
1111111110110000011100000111111
100000000011000001110111111111111
11110111111111011100000010001
11111111111111011101010010001
1000000110101011100000010001
11000000000000001100000010001
1100E00000000011010100100011
1101D1111010101111101111000111
110000011101010111110111100111
11110111 1110101 101111010001
11111111 1111111 111111111111

