C 141,124,107
F 68, 34,0
SO textures/yellow_bricks.xpm
NO textures/yellow_bricks.xpm
WE textures/yellow_bricks.xpm
EA textures/yellow_bricks.xpm
DO textures/door2.xpm

111111111111111111111
101000001000000000001
101010101011111110001
100010100010000010001
111110101111101011101
100000101000101000001
101111101011101111111
101000001010100000101
101011111D10111110101
101010001010100010101
101110101010101010101
100000101010001010001
111111101011111011101
100000101000100010001
101110101110101110111
101000100000100010101
101011111111111010101
100000000000000010001
1011D101110111111111D1
1N0000001000000000001
111111111111111111111