C 226,30,0
F 220,100,0
SO textures/p1.xpm
NO textures/p2.xpm
WE textures/p3.xpm
EA textures/p4.xpm


1111111111111111111111111
1000000000000000000000001
1011111011110111111011101
1000001000010100001000001
1011101011110101111011101
1000101000000001000000101
100010111111D111111111111
1000000010000000000000011
111111111D111111111111101
10000000001000000001
111D111111111111111111001
1000000000E00000000000101
1011101111110111111110101
1000001000000100000000001
1111111111111111111111111
