C 0,255,255
F 76,153,0
SO textures/p1.xpm
NO textures/p2.xpm
WE textures/p3.xpm
EA textures/p4.xpm
1111111111111111111111111
1000000000110000000000001
1011000001110000000000001
1001000000000000000000001
1111111110110000011100000111111
100000000000000001110111111111111
11110111111111011100000010001
11110111111111011101010010001
1000000110101011100000010001
10000000000000001100000010001
1N000000000000001101010010001
1100000111010101111101111000111
110000011101010111110111100111
11110111 1110101 101111010001
11111111 1111111 111111111111

